15 15
1 1 1 1 1 1 1 1 1 1 1 1 1 1 1
1 2 0 2 0 2 0 2 0 2 0 2 0 2 1
1 0 1 1 1 0 1 1 1 0 1 1 1 0 1
1 2 1 3 1 2 0 3 0 2 1 3 1 2 1
1 0 1 1 1 0 1 1 1 0 1 1 1 0 1
1 2 0 2 0 2 0 2 0 2 0 2 0 2 1
1 0 1 1 1 0 1 1 1 0 1 1 1 0 1
1 2 1 3 1 2 0 3 0 2 1 3 1 2 1
1 0 1 1 1 0 1 1 1 0 1 1 1 0 1
1 2 0 2 0 2 0 2 0 2 0 2 0 2 1
1 0 1 1 1 0 1 1 1 0 1 1 1 0 1
1 2 1 3 1 2 0 3 0 2 1 3 1 2 1
1 0 1 1 1 0 1 1 1 0 1 1 1 0 1
1 2 0 2 0 2 0 2 0 2 0 2 0 2 1
1 1 1 1 1 1 1 1 1 1 1 1 1 1 1
7 7 